========== =========
=                  =
==========         =

=    ===============
=                  =
=                  =
==========         =

=    ===============
=                  =
=                  =
==========         =

=    ===============
=r                b=
========== =========